11111111111111111111
1P0000000000000000E1
10000011111110000001
10001100000110000001
10001100000100000001
10C01100000110000001
10001100000001000001
11111111000111111111
11111111111111111111
