1111111111111
1P00C000C00C1
1M00001101111
100011E000011
1111111101111
10001M0000001
1011111111101
1000000001001
1000000010001
1000000100001
1000001000001
1000010000001
1000100000001
10010000000C1
1011110111111
1M00000000001
1111111111111