11111111111111111111111111111111111111
1P0000000000000000E1111111111111111111
10000011111110000001111111111111111111
10001100000110000001111111111111111111
10001100000100000001111111111111111111
10C01100000110000001111111111111111111
10001100000001000001111111111111111111
11111111000111111111111111111111111111
11111111111111111111111111111111111111

