1111111111111111111111111111111111
1E000000000000C00000C0M00000000001
1010010100100000101001000M0001P101
100100100101010100010010000010101
10000000C00C00000000M00000000000C1
1111111111111111111111111111111111