1111111111111111111111111111111111
1E00000M000000C00000C0M00000000001
1P0100101001M0000101001000M0001101
1001001001010101000100100000101011
10000000C00C00000000M00000000000C1
1111111111111111111111111111111111